##############################
##************##************##
##*####*#####*##*#####*####*##
##@####*#####*##*#####*####*##
##*####*#####*##*#####*####*##
##**************************##
##*####*##############*##0 ,,, *
##*####*******##*******    *
##******