 Score:            Lives:CCC
############################
#............##............#
#.####.#####.##.#####.####.#
#@####.#####.##.#####.####@#
#..........................#
#.####.##.########.##.####.#
#......##....##....##......#
######.##### ## #####.######
######.##          ##.######
######.## ###--### ##.######
######.## #      # ##.######
      .   #      #   .      
######.## #      # ##.######
######.## ######## ##.######
######.##          ##.######
######.## ######## ##.######
#............##............#
#.####.#####.##.#####.####.#
#@..##................##..@#
###.##.##.########.##.##.###
#......##....##....##......#
#.##########.##.##########.#
#..........................#
############################